B-CARDINAL	B-CARDINAL
B-DATE	B-DATE
B-EVENT	B-EVENT
B-FAC	B-FAC
B-GPE	B-GPE
B-LANGUAGE	B-LANGUAGE
B-LAW	B-LAW
B-LOC	B-LOC
B-MONEY	B-MONEY
B-NORP	B-NORP
B-ORDINAL	B-ORDINAL
B-ORG	B-ORG
B-PERCENT	B-PERCENT
B-PERSON	B-PERSON
B-PRODUCT	B-PRODUCT
B-QUANTITY	B-QUANTITY
B-TIME	B-TIME
B-WORK_OF_ART	B-WORK_OF_ART
I-CARDINAL	I-CARDINAL
I-DATE	I-DATE
I-EVENT	I-EVENT
I-FAC	I-FAC
I-GPE	I-GPE
I-LANGUAGE	I-LANGUAGE
I-LAW	I-LAW
I-LOC	I-LOC
I-MONEY	I-MONEY
I-NORP	I-NORP
I-ORDINAL	I-ORDINAL
I-ORG	I-ORG
I-PERCENT	I-PERCENT
I-PERSON	I-PERSON
I-PRODUCT	I-PRODUCT
I-QUANTITY	I-QUANTITY
I-TIME	I-TIME
I-WORK_OF_ART	I-WORK_OF_ART
O	O
